********************
*   *              *
*@  *  * ****      *
*   *  *    *      *
*   *  *   x*      *
*   *  *    *      *
*   *  ******      *
*                  *
*                  *
*                  *
*                  *
********************
