********************
*   *              *
*@  *  * ****      *
*   *  ~    *      *
*   *  ~~~ x*      *
*   *  *    ~      *
*   *  ******      *
*                  *
*                  *
*                  *
*                  *
********************
