******************************
*   *                        *
*   *      *   ********      *
*   *  @   *          *      *
*   *      *     x    *      *
*   *      *          *      *
*   *      ************      *
*                            *
*                            *
*                            *
*                            *
*                            *
*                            *
*                            *
*                            *
*                            *
*                            *
******************************
